%%%%%%%%%%%%%%%%%%%%%%%%%%%
%  % %       % %%      %  %
%     %    %     %  %     %
%     %   %        %% %% %%
%  %%%  %     % %%%%  %  %%
%     %% % %%%%       %%  %
%        % %  % %         %
%  % %  %%  %  %   %  %   %
%% % % %  %     %%        %
%     %   %  %%%%%    % % %
%        %   %%  %%  %  % %
%%     %%    %%   %  %  % %
%  %  %%% % %  %%  %  %   %
%     %%     % %    %     %
%           %   % %%    %%%
%   %  %%   %            %%
%            %    %      %%
%                    %    %
%    %       % %      %   %
%       %     % % %      %%
% % %% %   %       %      %
%%%%%%%%%%%%%%%%%%%%%%%%%%%
