%%%%%%%%%%%%%%%%%%%%%%%%%%%
%   %%%      %%  %%%%%%   %
% %  %%%%  %    %    %    %
%    %  %  %   %    %% %  %
%%        %   %     %     %
%  %    %   %%   %       %%
% %%%  %     % %      % %%%
%  %     %       %%  %    %
%    %%          % %%%% % %
% %       %% %        %  %%
%   %      %%      %   %  %
%%%  %   %  %  %        % %
% %    %    %% %       %  %
%     %  %  %     %       %
%   %   %              %% %
%         %   %% %        %
%%%     %          %      %
%  %        %  % % %     %%
%%  %% % %        %%  %   %
%%       % %  %    %      %
%    %    %% %  % %   % % %
%%%%%%%%%%%%%%%%%%%%%%%%%%%
