%%%%%%%%%%%%%%%%%%%%%%%%%%%
% %%%  %%                 %
%  %  %                   %
%% %              %%  % % %
%    %%      %   % %%   % %
%%   %   %   %%    % % %  %
%%             %   %  %%  %
%%     %  %  %    %   % %%%
%              %%%        %
%%       %%%  % %%    % %%%
%         % %             %
%   % % %%      %% % %%% %%
%%%   %%  %%    % %%    % %
%          %    %  %      %
%            %   %     %%%%
% %     % %    %%% %%% %%%%
% % %%   %%    %  %     % %
%    %       %%         % %
%         %     %  %      %
%     %  %       %% %     %
%  %%  %   %  %      % %% %
%%%%%%%%%%%%%%%%%%%%%%%%%%%
