%%%%%%%%%%%%%%%%%%%%%%%%%%%
%   %  %     %%   %   %   %
%  %       %     %%%     %%
%% %   %     %  %    %   %%
%   %    %  %%%   %% %  % %
%  %    %   % %%%    % %  %
%    % %    %  %          %
% %           %%   %  % % %
%   %      %  %   %  %%   %
%             %%%%   %  %%%
%%   %  %      %          %
% %%  %   %            %% %
%   %  %       %      %   %
%          %%%  % %  %    %
%              % %%% %    %
%   %%%   % % %  % %      %
%                  %%     %
%       %     %%% %%%  %% %
%      %  %  %%%%   %     %
%%%   %  %%  %      %   % %
%   % %    %       %%%%   %
%%%%%%%%%%%%%%%%%%%%%%%%%%%
