%%%%%%%%%%%%%%%%%%%%%%%%%%%
%     %   %  %%   % % %%  %
%%    % %%   %    %   %  %%
%    %      %   %  %      %
%% % %  %   %   %     %  %%
% %%  %%  % % %        % %%
%      %          %%     %%
%    %      %   %  %      %
%%        %       %% % %  %
%      %           %%     %
%   % %   %   %  % %      %
% %        %   %  % %%%%  %
%% %  %  %     %        % %
%     %        % %%% %%  %%
%    %  %  %%  %       %  %
%%%         %             %
%  %%%  %     %  %%     % %
%% %          % %         %
%  %   % %    %%    %%   %%
%    %%    %%  %%   %     %
%  % %%      %%%      %   %
%%%%%%%%%%%%%%%%%%%%%%%%%%%
