%%%%%%%%%%%%%%%%%%%%%%%%%%%
% % %    % %% % %      %  %
%                % % %%   %
%     %   %%%% %   %      %
% % % % %    %%   %   %% %%
%     %  %       %   %   %%
%  %    %        %%%     %%
%  % %%   %%   %      %  %%
% %  %     %       %  %  %%
%%%     %     %%          %
%          %  %  %       %%
%% % %  %%%    %%   %  %% %
% %      %  % %    % %    %
%         %%         %%   %
% %%    %      %%%   %  %%%
%    %            %%      %
%     %     %%       % % %%
%%         %      %       %
%        %    %     % %%% %
%    %%           %   %%% %
%      % %  %%%  %%%      %
%%%%%%%%%%%%%%%%%%%%%%%%%%%
