%%%%%%%%%%%%%%%%%%%%%%%%%%%
%   %      %     %%  %%   %
%%   %    %%  %%    %    %%
%%%        %%    %  %% % %%
% %     %          %   % %%
%  %    %%    %%   %      %
%   %  % %%%%%  %   %     %
%   %       %%    %  % %  %
%    %%%%   %  %%   %     %
%        %    % %     % % %
%  %    %%%%       %% %   %
% %  %%  %     %%         %
%  %   %    %       %     %
% %%%%  %      %       %  %
%     %%  %    %%      %  %
%  %% %  %  %    %      % %
%               % % %%    %
%  %%         %   %%      %
%      %  %    % %   %%   %
% %  %  %   %%       %    %
%  %    %     %      %    %
%%%%%%%%%%%%%%%%%%%%%%%%%%%
