%%%%%%%%%%%%%%%%%%%%%%%%%%%
%   % %        %   %  %   %
%%    %%%    %      %  %  %
%% %  %%       %      %   %
%%        %   %  %%      %%
%   %%% %      %          %
%  %       %   % %   %%% %%
%   %  %%     % %       % %
%      %%%%%%%       % %% %
%   %  %   %  %     %     %
% % %%  %         %   %% %%
%%   %           %        %
%%%%%               %   % %
%    %  %    %            %
%   %  % %      % %    % %%
%                  %%  %  %
%%% %%%%%       %    %%%%%%
%   %    %    %       %  %%
% %%   %% %%     %% % %   %
%     % % %  % %  %%%     %
% %                       %
%%%%%%%%%%%%%%%%%%%%%%%%%%%
