%%%%%%%%%%%%%%%%%%%%%%%%%%%
%     %         %%%    %  %
% % %  %  %            %  %
%     % %  %% %   %%%  %% %
%    %%   %    % %%       %
%    %    %      %  %%   %%
% %%       % %  %%   % %%%%
%     % %%%   %    % %    %
% % %    % %  % %  %%%    %
%     %    %     %        %
%   % %   %    %     %   %%
%    %%        %   %%     %
%  %%       %   %  %%     %
%   % %%%        %  %   % %
%    %   % %%%   %        %
%  %  %    %     %   %    %
%     %% %  %       %   %%%
%          %  %  % %%%%   %
%       %% %  %  % %      %
% %  %         %%      %  %
%       %         %%  %   %
%%%%%%%%%%%%%%%%%%%%%%%%%%%
