%%%%%%%%%%%%%%%%%%%%%%%%%%%
%  %%  % %   %   %%    %  %
%%     %       %        % %
%                 % % %%  %
%  %     % %           %% %
% %   % %      %   %  %   %
%%%%     %   % %  %  %%%  %
%   %  %%  %   %   % %%   %
%%  %    %    %       %%  %
%%      %   %   %%  %  %  %
%%       %    %    % %%   %
%  %    %   %%%  %    % % %
%%  %   %   %     %       %
% % %%   %  %     %%%     %
%   %% % %% %  %%%  %     %
%   % %   % %           % %
% % %    %         %     %%
%               %    %    %
%    %  %%    % %%%  %   %%
%  % %%  %%%              %
%  %    %%                %
%%%%%%%%%%%%%%%%%%%%%%%%%%%
