%%%%%%%%%%%%%%%%%%%%%%%%%%%%%%%%%%%%%
%       % % %           %   %     % %
% %%%%%%% % %%% % %%% %%% %%%%%%% % %
%       %       % %     %     % %   %
%%%%% %%%%% %%% % % % %%% %%%%% % %%%
%   % % % %   % % % %   % %   % %   %
% %%% % % % %%% %%%%% %%% % %%% %%% %
%       %     %   %   %     % % %   %
%%% %%%%%%%%% %%%%%%% %%% %%% % % % %
%             %       % %   %     % %
% % %%%%% % %%% % % %%% % %%% %%% % %
% % %     % % % % %     %   % % % % %
% % % %%%%%%% % %%%%%%%%% %%% % %%% %
% % % %     %   %     %     %   %   %
%%% %%% % %%%%% %%%%% %%% %%% %%%%% %
%     % % %     % %.    % %   % % % %
% % % % % %%% %%% %%% %%% % % % % % %
% % % % %                 % % %     %
%%% %%%%%%% % % %%%%% %%% % %%%P%%%%%
%       % % % %     %   %     % %   %
%%%%% % % %%%%%%%%% %%%%%%%%%%% % %%%
%   % %           % %     %   % %   %
% %%% %%%%% %%%%%%%%% %%%%% % % %%% %
% %   %      %        %     %       %
% % % %%%%% %%% % % % % %%%%%%%%%%%%%
% % %   %     % % % %       %   % % %
% % %%% %%% % % % %%%%%%%%% %%% % % %
% %   % %   % % %   % %   % % %     %
% %%% %%% %%%%% %%% % % %%%%% % %%%%%
%       %   %     % %     %   % %   %
%%% % %%%%% %%%%% %%% %%% % %%% % %%%
% % % % % % % %     % %   % %   % % %
% % %%% % % % % %%%%%%%%% % % % % % %
%   %   %   %                 %     %
% % % % %%% %%% %%%%%%% %%% %%% %%% %
% % % %       %   %       %   % %   %
%%%%%%%%%%%%%%%%%%%%%%%%%%%%%%%%%%%%%
