%%%%%%%%%%%%%%%%%%%%%%
% %%     %           %
%    % %%%%%%%    %  %
% %%%  %    % %   %  %
%%%   %% %      %%   %
%%%   %%%%%%%%       %
%%%% %%%   %%% %     %
% %% %  %      %   %%%
%    %  % %%%  % % % %
%          %%   %%%  %
%   % %%%  %         %
%    % %    % % %%%  %
%%%     %   %%  % %  %
% %     %  %         %
% %   %  %%%      %% %
%           %%  %%%  %
%%%%%%%%%%%%%%%%%%%%%%
