%%%%%%%%%%%%%%%%%%%%%%%%%%%%%%%
%            %%%%%            %
%%% %   %%%         % %   % %%%
%   %%% % %%%% % %%%%%% %%%   %
% %     %      %      %     % %
% %%% %%%%% %%%%%%% %%% % %%%%%
%     %             %   %     %
%%%%%%%%%%%%%%%%%%%%%%%%%%%%%%%
