%%%%%%%%%%%%%%%%%%%%%%%%%%%%%%%%%%%%
%                                  %
% %%%%%%%%%%%%%%%%%%%%%%% %%%%%%%% %
% %%   %   %      %%%%%%%   %%     %
% %% % % % % %%%% %%%%%%%%% %% %%%%%
% %% % % % %             %% %%P    %
% %% % % % % % %%%%  %%%    %%%%%% %
% %  % % %   %    %% %%%%%%%%      % 
% %% % % %%%%%%%% %%        %% %%%%%
% %% %   %%       %%%%%%%%% %%     %
%    %%%%%% %%%%%%%      %% %%%%%% %
%%%%%%      %       %%%% %% %      %
%      %%%%%% %%%%% %    %% %% %%%%%
% %%%%%%      %       %%%%% %%     %
%        %%%%%% %%%%%%%%%%% %%  %% %
%%%%%%%%%%    .             %%%%%% %
%          %%%%%%%%%%%%%%%%        %
%%%%%%%%%%%%%%%%%%%%%%%%%%%%%%%%%%%%
