%%%%%%%%%%%%%%%%%%%%%%
%   %   %     %  %%  %
%     %%% %%     %%  %
%            %%%%%%  %
%% %%% % %%       %  %
%  %   %   %%%    %  %
%% %% %   %%%%%%%%   %
%   %  %%%%%   % %   %
%   % %     %  %     %
% %%    %%   % %%    %
% % %%%    % % %% %  %
% %     % %       %  %
%% %     %  % % %    %
%    %%   %%%  %%   %%
%% %  %    %         %
%  % %   %  %%     % %
%%%%%%%%%%%%%%%%%%%%%%
