%%%%%%%%%%%%%%%%%%%%%%
%         %     %%%% %
%   %  % %% %%% %  % %
%%  %%   %     %%%   %
%%   % % % %    %%% %%
%  %   %         %% %%
%  %     % % %   %   %
%   %  %    %      % %
% %%%%%%  %% %   % % %
%            %% %  % %
%%    %% %%   %   %%%%
%%%%%%% %%%%  %  %%  %
%        % %  %% %   %
%       %% %%        %
%    %     %% %  %   %
% %   %%      % %    %
%%%%%%%%%%%%%%%%%%%%%%
