%%%%%%%%%%%%%%%%%%%%%%
% %%   % % %% %%     %
%          %%  % %   %
%  %     %  %    % % %
%      %  %     %    %
%   % %    %    %%   %
%  % %% %   %     %% %
% %% %  % % %      %%%
%  %   %  %   % %   %%
% %%  %   %%  % %%% %%
% %%%%% % %%%%       %
%       % %%%   %%%% %
%    %%%  % %     %% %
%% %%%       %   %   %
%  %     %% % %% %   %
%  % %  %%      %%   %
%%%%%%%%%%%%%%%%%%%%%%
