%%%%%%%%%%%%%%%%%%%%%%
%  %    %%%  %%%%%   %
% % % %%       % % % %
%     %     % %      %
% %  %%%%  %%%     % %
%   %%%%    %   %%%  %
% %     % % % % %%   %
%  %%%  %%  %%  % %% %
% %%%   % %    %     %
%     %      %       %
%%  %  %%% %%%%  %%% %
%    % %     %% %%  %%
%    %%% %       %%  %
%% % %      %    %   %
%  % %     % % %%    %
% %  %            %  %
%%%%%%%%%%%%%%%%%%%%%%
