%%%%%%%%%%%%%%%%%%%%%%
%   %  % %      %    %
% %  %    % % % %%% %%
%%       %%  %% %%%  %
%%%      %      % % %%
%   % %%   %% %      %
% % % % %  %%    %   %
%  %      %% % %%    %
% %  %   %%   %%     %
% %%%  %  %     % % %%
%      %%   %%% % %  %
%  %%%    %   %%   % %
%    %%     %%     %%%
%      %% %%%  %%    %
%  %  %          % %%%
%  % %   %%% % %%    %
%%%%%%%%%%%%%%%%%%%%%%
