%%%%%%%%%%%%%%%%%%%%%%
%  %%%      %%     % %
%      %        % %% %
%     %%   %%  %     %
%%  %   %% %   % %%  %
%     %%   % %  % %  %
% % %  % %    %%%    %
%% %   % %%% %%%%% % %
%  %  %   %% %%  % % %
% %  %%% %    % %% %%%
%        %% %    % % %
%    %  %    %  %%   %
%%%%  %%%      %   % %
%%%  %  % %   %      %
% %      %      %%%  %
%     %  % %  %%     %
%%%%%%%%%%%%%%%%%%%%%%
