%%%%%%%%%%%%%%%%%%%%%%
%   %%        % %    %
% %%%%% %%%%      %  %
% %  %%       %  %   %
%    %%% %%          %
%% %  %% %%   % % %%%%
%  %%    % %%% %     %
% %%  % %   %    %  %%
%          %  % %  % %
% %% %       %  %%   %
%  %  %  % %   %%%% %%
% %     %%% %  %  %  %
%    %  % %       %  %
%   %  %  % %  % %   %
% % %%  % %   %     %%
%  %%% %%     %%%    %
%%%%%%%%%%%%%%%%%%%%%%
