%%%%%%%%%%%%%%%%%%%%%%
%  %%% %  %% %%  %%  %
%  %         %    %% %
%% %    % % %   %    %
%   %     % %%% % % %%
%% %      %%%    %%%%%
%% %%%      %   %    %
%   %%% %%  %%% %    %
%% % %       %% %%% %%
%      %% %%%    %%  %
%  %     %  %     %% %
%             %%     %
%       % % %      % %
%%  %%%  % %%% %%  % %
%    %%  %      %%%  %
% %         %  %%    %
%%%%%%%%%%%%%%%%%%%%%%
