%%%%%%%%%%%%%%%%%%%%%%
%   %       %    %%% %
% % %%   % % %%      %
% %   %%  %% %%% %%%%%
%  %   %% %   %   %% %
%  % %       %%      %
%  %          %   %%%%
%  %%  %%  % %%     %%
% %   %  %%       % %%
% %%%%% %%%%  %%     %
%%   %%   %%    % %%%%
%%   %%  %%% %   %   %
% %     %% %%      %%%
%   %       %  %  %  %
%       %            %
%      %%%%%%        %
%%%%%%%%%%%%%%%%%%%%%%
