%%%%%%%%%%%%%%%%%%%%%%
% %%        % %      %
% .  %%%%%% % %%%%%% %
%%%%%%        %      %
%    % %%%%%% %% %%%%%
% %%%% %         %   %
%        %%% %%%   % %
%%%%%%%%%%    %%%%%% %
%     P    %%        %
%%%%%%%%%%%%%%%%%%%%%%
