%%%%%%%%%%%%%%%%%%%%%%
% %%       .% %      %
%    %%%%%% % %%%%%% %
%%%%%%        %    P %
%    % %%%%%% %% %%%%%
% %%%% %         %   %
%        %%% %%%   % %
%%%%%%%%%%    %%%%%% %
%          %%        %
%%%%%%%%%%%%%%%%%%%%%%
