%%%%%%%%%%%%%%%%%
%         % %%  %
%  % %%   %  % %%
% %%    %       %
%%%%    %   %   %
%% %%  %   %%  %%
%%  %    %   %  %
%%    %% %%   %%%
%  %%%  %%  %  %%
%       %   % % %
%   %%%   % %   %
%%%%%%%%%%%%%%%%%
