%%%%%%%%%%%%%%%%%%%%%%
% %%        % %      %
%    %%%%%% % %%%%%%P%
%%%%%%        %      %
%    % %%%%%% %% %%%%%
% %%%% %         %   %
% .      %%% %%%   % %
%%%%%%%%%%    %%%%%% %
%          %%        %
%%%%%%%%%%%%%%%%%%%%%%
