%%%%%%%%%%%%%%%%%%%%%%
% %%        % %      %
%    %%%%%% % %%%%%% %
%%%%%%        %      %
%    % %%%%%% %% %%%%%
% %%%% %         %   %
%   .    %%% %%%   % %
%%%%%%%%%%    %%%%%% %
%     P    %%        %
%%%%%%%%%%%%%%%%%%%%%%
