%%%%%%%%%%%%%%%%%%%%%%
% %%        % %      %
%    %%%%%% % %%%%%% %
%%%%%%        %      %
%    % %%%%%% %% %%%%%
% %%%% %    .    %   %
%        %%% %%%   % %
%%%%%%%%%%    %%%%%% %
%          %%  P     %
%%%%%%%%%%%%%%%%%%%%%%
