%%%%%%%%%%%%%%%%%%%%%%
% %% P      % %      %
%    %%%%%% % %%%%%% %
%%%%%%        %      %
%    % %%%%%% %% %%%%%
% %%%% %         %   %
%        %%% %%%   % %
%%%%%%%%%%    %%%%%% %
% .        %%        %
%%%%%%%%%%%%%%%%%%%%%%
