%%%%%%%%%%%%%%%%%%%%%%
% %%        % %      %
%    %%%%%% % %%%%%% %
%%%%%%        %      %
%    % %%%%%% %% %%%%%
% %%%% %         %   %
% .      %%% %%%   % %
%%%%%%%%%%    %%%%%%P%
%          %%        %
%%%%%%%%%%%%%%%%%%%%%%
