%%%%%%%%%%%%%%%%%%%%%%
% %%    .   % %      %
%P   %%%%%% % %%%%%% %
%%%%%%        %      %
%    % %%%%%% %% %%%%%
% %%%% %         %   %
%        %%% %%%   % %
%%%%%%%%%%    %%%%%% %
%          %%        %
%%%%%%%%%%%%%%%%%%%%%%
