%%%%%%%%%%%%%%%%%%%%%%
% %%        % %      %
%    %%%%%% % %%%%%% %
%%%%%%        %      %
%    % %%%%%% %% %%%%%
% %%%% %         %   %
%  .     %%% %%%   % %
%%%%%%%%%%    %%%%%% %
%          %%P       %
%%%%%%%%%%%%%%%%%%%%%%
