%%%%%%%%%%%%%%%%%%%%%%
% %%        % %      %
%   P%%%%%% % %%%%%% %
%%%%%%        %      %
%    % %%%%%% %% %%%%%
% %%%% %         %   %
%        %%% %%%   % %
%%%%%%%%%%    %%%%%% %
%          %% .      %
%%%%%%%%%%%%%%%%%%%%%%
