%%%%%%%%%%%%%%%%%%%%%%
% %%        % %      %
%    %%%%%% % %%%%%% %
%%%%%%        % .    %
%    % %%%%%% %% %%%%%
% %%%% %         %   %
%        %%% %%%   % %
%%%%%%%%%%    %%%%%% %
%   P      %%        %
%%%%%%%%%%%%%%%%%%%%%%
