%%%%%%%%%%%%%%%%%%%%%%
% %%        % %      %
%    %%%%%% % %%%%%% %
%%%%%%        %      %
%    % %%%%%% %% %%%%%
% %%%% %         % P %
%        %%% %%%   % %
%%%%%%%%%%  . %%%%%% %
%          %%        %
%%%%%%%%%%%%%%%%%%%%%%
