%%%%%%%%%%%%%%%%%%%%%%
% %%        % %      %
%    %%%%%% % %%%%%% %
%%%%%%        %      %
%    % %%%%%% %% %%%%%
% %%%% % P       %   %
%        %%% %%%   % %
%%%%%%%%%%    %%%%%% %
%          %%     .  %
%%%%%%%%%%%%%%%%%%%%%%
