%%%%%%%%%%%%%%%%%%%%%%
% %%        % %      %
%    %%%%%% % %%%%%% %
%%%%%%        %      %
%    % %%%%%% %%P%%%%%
% %%%% %         %.  %
%        %%% %%%   % %
%%%%%%%%%%    %%%%%% %
%          %%        %
%%%%%%%%%%%%%%%%%%%%%%
