%%%%%%%%%%%%%%%%%
%  %%%   %% %   %
%  % %%%     %  %
%     %    %    %
%%  %     %%  %%%
% %%       %%%  %
%       %% %%%% %
%    %%   % %%  %
%%% %%  %   %  %%
%   %%    %     %
%  %%%      % % %
%%%%%%%%%%%%%%%%%
