%%%%%%%%%%%%%%%%%
%   %%%%  % %   %
%%   %  %     %%%
%  % %     %  %%%
%%  %%   % %%   %
%       % % % % %
%% %  %     %%  %
%    %   %%    %%
%% %%    %%     %
%   % %% %  %% %%
%    %   %   %  %
%%%%%%%%%%%%%%%%%
