%%%%%%%%%%%%%%%%%
%   % %%%       %
%      %%%    %%%
% % %% %        %
%%% %% % %  %   %
%     %%%  %  %%%
% %       %%  % %
%   %%%      %% %
%      %% %% %% %
% %% %     %    %
%     %  %%% %  %
%%%%%%%%%%%%%%%%%
