%%%%%%%%%%%%%%%%%%%%%%
% %%        % %      %
%    %%%%%% % %%%%%% %
%%%%%%        %      %
%    % %%%%%% %% %%%%%
% %%%% %   .     %   %
%        %%% %%%   % %
%%%%%%%%%%    %%%%%% %
%          %%     P  %
%%%%%%%%%%%%%%%%%%%%%%
