%%%%%%%%%%%%%%%%%%%%%%
% %%        % % .    %
%    %%%%%% % %%%%%% %
%%%%%%        % P    %
%    % %%%%%% %% %%%%%
% %%%% %         %   %
%        %%% %%%   % %
%%%%%%%%%%    %%%%%% %
%          %%        %
%%%%%%%%%%%%%%%%%%%%%%
