%%%%%%%%%%%%%%%%%
%  % %  %%   %% %
%    %   % % %% %
%%     %    %%  %
%% % %  %% %    %
%   %%   %      %
%%  %%  %%  %% %%
%%%%%    % %    %
%%     %   %%   %
%%      %%%     %
%   % %    % %  %
%%%%%%%%%%%%%%%%%
