%%%%%%%%%%%%%%%%%
%         %%%   %
%%     %%  %%%% %
%% %  %         %
%% %%   %%  % % %
%% %   %   % %  %
%   % %%  %%  % %
%%  %  %     %  %
%%%   %   %   %%%
%    %%%   %%   %
%      % %%   % %
%%%%%%%%%%%%%%%%%
