%%%%%%%%%%%%%%%%%%%%%%
% %%        % %      %
%    %%%%%% % %%%%%% %
%%%%%%        %      %
%    % %%%%%% %% %%%%%
% %%%% %         %   %
%        %%% %%% P % %
%%%%%%%%%%    %%%%%% %
%    .     %%        %
%%%%%%%%%%%%%%%%%%%%%%
