%%%%%%%%%%%%%%%%%%%%%%
% %%        % %      %
%   .%%%%%% % %%%%%% %
%%%%%%        %P     %
%    % %%%%%% %% %%%%%
% %%%% %         %   %
%        %%% %%%   % %
%%%%%%%%%%    %%%%%% %
%          %%        %
%%%%%%%%%%%%%%%%%%%%%%
