%%%%%%%%%%%%%%%%%%%%%%
% %%        % %      %
%    %%%%%% % %%%%%% %
%%%%%%        %      %
%    % %%%%%% %% %%%%%
% %%%% %         %   %
%        %%% %%%   %.%
%%%%%%%%%%  P %%%%%% %
%          %%        %
%%%%%%%%%%%%%%%%%%%%%%
