%%%%%%%%%%%%%%%%%%%%
%                  %
% %% %% %% %% %% % %
% %% %           % %
%%%%%%%%%%%%%%%%%%%%
