%%%%%%%%%%%%%%%%%%%%%%
% %%  .     % %      %
%    %%%%%% % %%%%%% %
%%%%%%        %      %
%    % %%%%%% %% %%%%%
% %%%% %         %   %
%        %%% %%%   % %
%%%%%%%%%%    %%%%%% %
%      P   %%        %
%%%%%%%%%%%%%%%%%%%%%%
