%%%%%%%%%%%%%%%%%
%   %  %%    %  %
%%%   %% %      %
%   % %  %%  %  %
%     %% %%%    %
%  %  %     %%  %
% %%%      %% % %
%  %  %%%  %    %
% % %   %% %%  %%
% % %%% %%%% %  %
%               %
%%%%%%%%%%%%%%%%%
