%%%%%%%%%%%%%%%%%%%%%%
%.%%        % %      %
%    %%%%%% % %%%%%% %
%%%%%%        %      %
%    % %%%%%% %% %%%%%
% %%%% %  P      %   %
%        %%% %%%   % %
%%%%%%%%%%    %%%%%% %
%          %%        %
%%%%%%%%%%%%%%%%%%%%%%
