%%%%%%%%%%%%%%%%%%%%%%
% %%        % %.     %
%    %%%%%% % %%%%%% %
%%%%%%        %      %
%    % %%%%%% %% %%%%%
% %%%% %         %   %
%        %%% %%%   % %
%%%%%%%%%%    %%%%%%P%
%          %%        %
%%%%%%%%%%%%%%%%%%%%%%
