%%%%%%%%%%%%%%%%%%%%%%
% %%        % %      %
%    %%%%%% % %%%%%% %
%%%%%%        %      %
%    % %%%%%% %% %%%%%
% %%%% % .       %   %
%        %%% %%%   % %
%%%%%%%%%% P  %%%%%% %
%          %%        %
%%%%%%%%%%%%%%%%%%%%%%
