%%%%%%%%%%%%%%%%%%%%%%
% %%        % %      %
%P   %%%%%% % %%%%%% %
%%%%%%        %      %
%    % %%%%%% %% %%%%%
% %%%% %         %   %
%        %%% %%%   % %
%%%%%%%%%%    %%%%%% %
%     .    %%        %
%%%%%%%%%%%%%%%%%%%%%%
