%%%%%%%%%%%%%%%%%%%%%%
% %%        % %      %
%P . %%%%%% % %%%%%% %
%%%%%%        %      %
%    % %%%%%% %% %%%%%
% %%%% %         %   %
%        %%% %%%   % %
%%%%%%%%%%    %%%%%% %
%          %%        %
%%%%%%%%%%%%%%%%%%%%%%
