%%%%%%%%%%%%%%%%%%%%%%
% %%      . % %      %
%    %%%%%% % %%%%%% %
%%%%%%        %      %
%    % %%%%%% %% %%%%%
% %%%% %         %   %
%        %%% %%%   % %
%%%%%%%%%%    %%%%%% %
%   P      %%        %
%%%%%%%%%%%%%%%%%%%%%%
