%%%%%%%%%%%%%%%%%
%   %%       %  %
%%    %%  %     %
%           %%% %
% %%%  %%% %% %%%
% %   %% %    %%%
%%     %   %%   %
%   %%%%% %     %
% %%   %%   %   %
%          %  % %
%  % % % %%  %% %
%%%%%%%%%%%%%%%%%
