%%%%%%%%%%%%%%%%%%%%%%
% %%        % %      %
%    %%%%%% % %%%%%% %
%%%%%%        %      %
%    % %%%%%% %% %%%%%
% %%%% %  .      %   %
%        %%% %%%   % %
%%%%%%%%%%    %%%%%% %
% P        %%        %
%%%%%%%%%%%%%%%%%%%%%%
