%%%%%%%%%%%%%%%%%
% %  %     %    %
%   %   %    %% %
% %   %%   % % %%
% %%     %%  %  %
%  %%% %   % %  %
%%   % %      % %
%% % % %  %% %% %
%    % % %%     %
%    % % %%     %
% %   %%   %% % %
%%%%%%%%%%%%%%%%%
