%%%%%%%%%%%%%%%%%%%%%%
% %%        % %      %
%    %%%%%% % %%%%%% %
%%%%%%        %      %
%    % %%%%%% %% %%%%%
% %%%% %   .     %   %
%        %%% %%%   % %
%%%%%%%%%%P   %%%%%% %
%          %%        %
%%%%%%%%%%%%%%%%%%%%%%
