%%%%%%%%%%%%%%%%%%%%%%
% %%        % %      %
%    %%%%%%P% %%%%%% %
%%%%%%        %      %
%    % %%%%%% %% %%%%%
% %%%% %         %.  %
%        %%% %%%   % %
%%%%%%%%%%    %%%%%% %
%          %%        %
%%%%%%%%%%%%%%%%%%%%%%
