%%%%%%%%%%%%%%%%%%%%%%
% %%        % %      %
%    %%%%%% % %%%%%% %
%%%%%%        %      %
%    % %%%%%% %% %%%%%
% %%%% %    P    %   %
%        %%% %%%   % %
%%%%%%%%%%    %%%%%% %
%          %%   .    %
%%%%%%%%%%%%%%%%%%%%%%
