%%%%%%%%%%%%%%%%%
%  %%       %%% %
%  %%%    %%%%% %
%%     %   %%   %
%%  % %%    %  %%
%%%  % % %     %%
%    %  %   % %%%
%       %   %%  %
%  %%     % %%% %
%   % % %     % %
% % % %         %
%%%%%%%%%%%%%%%%%
