%%%%%%%%%%%%%%%%%%%%%%
% %%        % % .    %
%    %%%%%% % %%%%%% %
%%%%%%        %      %
%   P% %%%%%% %% %%%%%
% %%%% %         %   %
%        %%% %%%   % %
%%%%%%%%%%    %%%%%% %
%          %%        %
%%%%%%%%%%%%%%%%%%%%%%
