%%%%%%%%%%%%%%%%%%%%%%
% %%        % %      %
%    %%%%%% %P%%%%%% %
%%%%%%        %      %
%    % %%%%%% %% %%%%%
% %%%% %         %   %
%        %%% %%%   % %
%%%%%%%%%%    %%%%%% %
%          %%.       %
%%%%%%%%%%%%%%%%%%%%%%
