%%%%%%%%%%%%%%%%%%%%%%
% %%        % %      %
%    %%%%%% % %%%%%% %
%%%%%%        %      %
%  P % %%%%%% %% %%%%%
% %%%% %         %   %
%        %%% %%%   % %
%%%%%%%%%%    %%%%%% %
%    .     %%        %
%%%%%%%%%%%%%%%%%%%%%%
