%%%%%%%
%     %
% %%% %
%  %  %
%% P.%%
%  %%%%
%%%%%%%
