%%%%%%%
%     %
% %%% %
%  %P %
%%   %%
%. %%%%
%%%%%%%
