%%%%%%%
%     %
% %%%P%
%  %  %
%%   %%
%. %%%%
%%%%%%%
