%%%%%%%
%  .P %
% %%% %
%  %  %
%%   %%
%  %%%%
%%%%%%%
