%%%%%%%
%     %
% %%% %
% .%P %
%%   %%
%  %%%%
%%%%%%%
