%%%%%%%
%     %
% %%% %
%  % P%
%%.  %%
%  %%%%
%%%%%%%
