%%%%%%%
%     %
% %%% %
%  % P%
%%   %%
%. %%%%
%%%%%%%
