%%%%%%%
%     %
% %%%P%
%  %  %
%%   %%
% .%%%%
%%%%%%%
