%%%%%%%
%   . %
% %%% %
%  %  %
%%   %%
% P%%%%
%%%%%%%
