%%%%%%%
%     %
% %%%.%
%  %  %
%%P  %%
%  %%%%
%%%%%%%
