%%%%%%%
%     %
% %%% %
%P %. %
%%   %%
%  %%%%
%%%%%%%
