%%%%%%%
% P   %
% %%% %
% .%  %
%%   %%
%  %%%%
%%%%%%%
