%%%%%%%%%%%%
% %%% %%%  %
%      %  %%
%% % %    %%
%     %% %%%
% %% %%    %
%%%%%%%%%%%%
