%%%%%%%
%     %
% %%% %
% .%  %
%%   %%
% P%%%%
%%%%%%%
