%%%%%%%%%%%%
%  %%% %   %
%%       % %
%%  %  % % %
%%%%% %%  %%
%     %%%  %
%%%%%%%%%%%%
