%%%%%%%
%     %
% %%% %
%  % P%
%%  .%%
%  %%%%
%%%%%%%
