%%%%%%%
%P    %
% %%% %
%  % .%
%%   %%
%  %%%%
%%%%%%%
