%%%%%%%
%   P.%
% %%% %
%  %  %
%%   %%
%  %%%%
%%%%%%%
