%%%%%%%
%P    %
% %%% %
%  %  %
%%   %%
% .%%%%
%%%%%%%
