%%%%%%%
% P   %
% %%% %
%  %  %
%%   %%
% .%%%%
%%%%%%%
