%%%%%%%
%     %
% %%%.%
%  %  %
%% P %%
%  %%%%
%%%%%%%
