%%%%%%%
%     %
%.%%% %
%P %  %
%%   %%
%  %%%%
%%%%%%%
