%%%%%%%
%     %
% %%% %
%  %. %
%%   %%
%P %%%%
%%%%%%%
