%%%%%%%%%%%%
%  %%% %%% %
%   %      %
%     % %  %
%  % %%%%% %
% %%  %%%  %
%%%%%%%%%%%%
