%%%%%%%
%    P%
%.%%% %
%  %  %
%%   %%
%  %%%%
%%%%%%%
