%%%%%%%
%.    %
% %%% %
%  % P%
%%   %%
%  %%%%
%%%%%%%
