%%%%%%%
%     %
% %%% %
%  %. %
%%P  %%
%  %%%%
%%%%%%%
