%%%%%%%%%%%%
% %%    %  %
%     %   %%
% %% %  %% %
% %%%%%    %
% %%%%%    %
%%%%%%%%%%%%
