%%%%%%%
%     %
% %%% %
%P %  %
%%   %%
% .%%%%
%%%%%%%
