%%%%%%%
%     %
% %%% %
%. %  %
%%   %%
% P%%%%
%%%%%%%
