%%%%%%%
%   . %
% %%% %
% P%  %
%%   %%
%  %%%%
%%%%%%%
