%%%%%%%
%   P %
% %%% %
%  %  %
%%  .%%
%  %%%%
%%%%%%%
