%%%%%%%
%     %
% %%%P%
%  %. %
%%   %%
%  %%%%
%%%%%%%
