%%%%%%%
%     %
% %%% %
%  %  %
%%   %%
%  %%%%
%%%%%%%
