%%%%%%%
%.    %
%P%%% %
%  %  %
%%   %%
%  %%%%
%%%%%%%
