%%%%%%%
%     %
% %%% %
%  %  %
%%.P %%
%  %%%%
%%%%%%%
