%%%%%%%%%%%%
% %   %%%% %
% %  %%% % %
% %% %%% % %
%    % % % %
% %        %
%%%%%%%%%%%%
