%%%%%%%
%P    %
% %%% %
%  %  %
%%  .%%
%  %%%%
%%%%%%%
