%%%%%%%
%  .  %
% %%% %
%  %  %
%%  P%%
%  %%%%
%%%%%%%
