%%%%%%%
%.  P %
% %%% %
%  %  %
%%   %%
%  %%%%
%%%%%%%
