%%%%%%%
%P    %
% %%% %
%  %  %
%%.  %%
%  %%%%
%%%%%%%
