%%%%%%%
%     %
% %%% %
%  % P%
%%   %%
% .%%%%
%%%%%%%
