%%%%%%%%
%      %
%      %
% %%%% %
% %    %
% % %%%%
% %    %
%%%%%%%%
