%%%%%%%
%     %
% %%% %
%.P%  %
%%   %%
%  %%%%
%%%%%%%
