%%%%%%%
%     %
% %%% %
%  %. %
%% P %%
%  %%%%
%%%%%%%
