%%%%%%%
%P    %
% %%%.%
%  %  %
%%   %%
%  %%%%
%%%%%%%
