%%%%%%%%%%%%
%    %%%%% %
% %%    %  %
%%%%% %   %%
%%%     %  %
%   %%   % %
%%%%%%%%%%%%
