%%%%%%%
%     %
%.%%% %
%  % P%
%%   %%
%  %%%%
%%%%%%%
