%%%%%%%
% P . %
% %%% %
%  %  %
%%   %%
%  %%%%
%%%%%%%
