%%%%%%%
%     %
% %%% %
%  %  %
%%  .%%
%P %%%%
%%%%%%%
