%%%%%%%
%.P   %
% %%% %
%  %  %
%%   %%
%  %%%%
%%%%%%%
