%%%%%%%
%     %
% %%%P%
%  % .%
%%   %%
%  %%%%
%%%%%%%
