%%%%%%%
%    .%
% %%% %
%  %P %
%%   %%
%  %%%%
%%%%%%%
