%%%%%%%
% P   %
% %%% %
%  %  %
%%  .%%
%  %%%%
%%%%%%%
