%%%%%%%
%    .%
% %%% %
%  % P%
%%   %%
%  %%%%
%%%%%%%
