%%%%%%%%%%%%
%      %%% %
%  % % %%  %
%   %%    %%
% %%%  %%  %
% %%   %%% %
%%%%%%%%%%%%
