%%%%%%%
% P   %
% %%% %
%  %  %
%% . %%
%  %%%%
%%%%%%%
