%%%%%%%
%     %
% %%% %
%. %  %
%%   %%
%P %%%%
%%%%%%%
