%%%%%%%
%     %
% %%% %
%. %  %
%% P %%
%  %%%%
%%%%%%%
