%%%%%%%
%     %
% %%% %
%  %  %
%%. P%%
%  %%%%
%%%%%%%
