%%%%%%%
%  P  %
% %%% %
%  %  %
%% . %%
%  %%%%
%%%%%%%
