%%%%%%%
%   P %
% %%% %
%. %  %
%%   %%
%  %%%%
%%%%%%%
