%%%%%%%
%     %
% %%% %
%  %  %
%%  P%%
%. %%%%
%%%%%%%
