%%%%%%%
%.    %
% %%% %
%  %  %
%%   %%
% P%%%%
%%%%%%%
