%%%%%%%
%     %
% %%%.%
%  %  %
%%  P%%
%  %%%%
%%%%%%%
