%%%%%%%
%P  . %
% %%% %
%  %  %
%%   %%
%  %%%%
%%%%%%%
