%%%%%%%
%.    %
% %%% %
%  %P %
%%   %%
%  %%%%
%%%%%%%
