%%%%%%%
%    .%
%P%%% %
%  %  %
%%   %%
%  %%%%
%%%%%%%
