%%%%%%%
% P   %
% %%% %
%  %  %
%%   %%
%. %%%%
%%%%%%%
