%%%%%%%
% .   %
%P%%% %
%  %  %
%%   %%
%  %%%%
%%%%%%%
