%%%%%%%
%     %
% %%% %
%  %  %
%%.  %%
% P%%%%
%%%%%%%
