%%%%%%%
%  .  %
% %%% %
%  %  %
%% P %%
%  %%%%
%%%%%%%
