%%%%%%%
%     %
%P%%% %
%  % .%
%%   %%
%  %%%%
%%%%%%%
