%%%%%%%
%     %
%.%%%P%
%  %  %
%%   %%
%  %%%%
%%%%%%%
