%%%%%%%
%     %
% %%% %
%. %  %
%%P  %%
%  %%%%
%%%%%%%
