%%%%%%%%%%%%
%  %%%%  % %
% %% %%%   %
% %% % %%% %
%          %
%  %% %%   %
%%%%%%%%%%%%
