%%%%%%%
%P    %
% %%% %
%  %  %
%% . %%
%  %%%%
%%%%%%%
