%%%%%%%%%%%%
%  % %%%%% %
%%   %%  % %
%% % %     %
%%%% %  %%%%
%          %
%%%%%%%%%%%%
