%%%%%%%
%     %
% %%% %
%  %  %
%%  .%%
% P%%%%
%%%%%%%
