%%%%%%%
%     %
% %%% %
% .%  %
%% P %%
%  %%%%
%%%%%%%
