%%%%%%%%%
%       %
%%%% %% %
%       %
% %% %% %
% %     %
%%%%%%%%%
