%%%%%%%
%P   .%
% %%% %
%  %  %
%%   %%
%  %%%%
%%%%%%%
