%%%%%%%
%  P  %
% %%% %
% .%  %
%%   %%
%  %%%%
%%%%%%%
