%%%%%%%
%     %
%P%%% %
%. %  %
%%   %%
%  %%%%
%%%%%%%
