%%%%%%%%%%%%
% %%    %% %
%  % %%  % %
%%    %% % %
%% %% %%   %
%  %   %%  %
%%%%%%%%%%%%
