%%%%%%%
%     %
% %%% %
% P%  %
%%   %%
%. %%%%
%%%%%%%
