%%%%%%%
%   .P%
% %%% %
%  %  %
%%   %%
%  %%%%
%%%%%%%
