%%%%%%%
% P  .%
% %%% %
%  %  %
%%   %%
%  %%%%
%%%%%%%
