%%%%%%%
%     %
% %%% %
%  %P %
%%   %%
% .%%%%
%%%%%%%
