%%%%%%%
%     %
% %%% %
% .% P%
%%   %%
%  %%%%
%%%%%%%
