%%%%%%%
%P    %
% %%% %
%  %  %
%%   %%
%. %%%%
%%%%%%%
