%%%%%%%
%  .  %
% %%% %
%  %  %
%%   %%
% P%%%%
%%%%%%%
