%%%%%%%
%     %
% %%% %
% P% .%
%%   %%
%  %%%%
%%%%%%%
