%%%%%%%
%     %
% %%% %
%  %  %
%%   %%
%P.%%%%
%%%%%%%
